9 9
7 1
1 5 
#########
#...#...#
#.#.#.###
#.#.#...#
#.#####.#
#.....#.#
###.#.#.#
#...#...#
#########